.F.........F.
Ff.........fF
.............
...RRRFRRR...
.............
Ff.........fF
.F.........F.