R...........R
.............
...f.....f...
.....F.F.....
...f.....f...
.............
R...........R