f00000000000f
0000000000000
0000000000000
000P00000P000
0000000000000
0000000000000
f00000000000f