.............
.P.........P.
....P...P....
..F...N...F..
....P...P....
.P.........P.
.............