S...........S
.............
...f.....f...
.....F.F.....
...f.....f...
.............
S...........S