.............
......F......
.....F.F.....
....F.O.F....
.....F.F.....
......F......
.............