RF.........FR
.RF.......FR.
..RF..f..FR..
.....N.f.....
..RF..f..FR..
.RF.......FR.
RF.........FR