f....R.R....f
.....R.R.....
RR.F.....F.RR
.....FOF.....
RR.F.....F.RR
.....R.R.....
f....R.R....f