fF.........Ff
.F.........F.
.F.........F.
.............
.F.........F.
.F.........F.
fF.........Ff