.............
.SSSSSSSSSSS.
.SO........S.
.SSSSSSSSS.S.
...........S.
.SSSSSSSSSSS.
.............