FP.........PF
Pf.........fP
.............
...SSSFSSS...
.............
Pf.........fP
FP.........PF