f....R.R....f
.....F.F.....
RRRRRR.RRRRRR
.............
RRRRRR.RRRRRR
.....F.F.....
f....R.R....f