Rf.........fR
f...........f
......R......
.....RFR.....
......R......
f...........f
Rf.........fR