f00000000000f
0000000000000
0000000000000
000F00000F000
0000000000000
0000000000000
f00000000000f