.............
.....N...F...
..P.....S....
...R...S.S...
...R....S....
....f.....O..
........H....
