RR000PPP000RR
R00000f00000R
P00000000000P
Pf000000000fP
P00000000000P
R00000f0000FR
RR000PPP000RR